parentOf	parentOf
sisterOf	sisterOf
brotherOf	brotherOf
motherOf	motherOf
fatherOf	fatherOf
grandmotherOf	grandmotherOf
grandfatherOf	grandfatherOf
greatGrandmotherOf	greatGrandmotherOf
greatGrandfatherOf	greatGrandfatherOf
auntOf	auntOf
uncleOf	uncleOf
greatAuntOf	greatAuntOf
greatUncleOf	greatUncleOf
secondAuntOf	secondAuntOf
secondUncleOf	secondUncleOf
girlCousinOf	girlCousinOf
boyCousinOf	boyCousinOf
girlSecondCousinOf	girlSecondCousinOf
boySecondCousinOf	boySecondCousinOf
girlFirstCousinOnceRemovedOf	girlFirstCousinOnceRemovedOf
boyFirstCousinOnceRemovedOf	boyFirstCousinOnceRemovedOf
daughterOf	daughterOf
sonOf	sonOf
granddaughterOf	granddaughterOf
grandsonOf	grandsonOf
greatGranddaughterOf	greatGranddaughterOf
greatGrandsonOf	greatGrandsonOf
nieceOf	nieceOf
nephewOf	nephewOf
male	male
female	female
