parentOf	parentOf
sisterOf	sisterOf
brotherOf	brotherOf
motherOf	motherOf
fatherOf	fatherOf
grandmotherOf	grandmotherOf
grandfatherOf	grandfatherOf
greatGrandmotherOf	greatGrandmotherOf
greatGrandfatherOf	greatGrandfatherOf
auntOf	auntOf
uncleOf	uncleOf
greatAuntOf	greatAuntOf
greatUncleOf	greatUncleOf
secondAuntOf	secondAuntOf
secondUncleOf	secondUncleOf
girlCousinOf	girlCousinOf
boyCousinOf	boyCousinOf
girlSecondCousinOf	girlSecondCousinOf
boySecondCousinOf	boySecondCousinOf
girlFirstCousinOnceRemovedOf	girlFirstCousinOnceRemovedOf
boyFirstCousinOnceRemovedOf	boyFirstCousinOnceRemovedOf
daughterOf	daughterOf
sonOf	sonOf
granddaughterOf	granddaughterOf
grandsonOf	grandsonOf
greatGranddaughterOf	greatGranddaughterOf
greatGrandsonOf	greatGrandsonOf
nieceOf	nieceOf
nephewOf	nephewOf
male	male
female	female
inverse_parentOf	childOf
inverse_sisterOf	inverse_sisterOf
inverse_brotherOf	inverse_brotherOf
inverse_motherOf	inverse_motherOf
inverse_fatherOf	inverse_fatherOf
inverse_grandmotherOf	inverse_grandmotherOf
inverse_grandfatherOf	inverse_grandfatherOf
inverse_greatGrandmotherOf	inverse_greatGrandmotherOf
inverse_greatGrandfatherOf	inverse_greatGrandfatherOf
inverse_auntOf	inverse_auntOf
inverse_uncleOf	inverse_uncleOf
inverse_greatAuntOf	inverse_greatAuntOf
inverse_greatUncleOf	inverse_greatUncleOf
inverse_secondAuntOf	inverse_secondAuntOf
inverse_secondUncleOf	inverse_secondUncleOf
inverse_girlCousinOf	inverse_girlCousinOf
inverse_boyCousinOf	inverse_boyCousinOf
inverse_girlSecondCousinOf	inverse_girlSecondCousinOf
inverse_boySecondCousinOf	inverse_boySecondCousinOf
inverse_girlFirstCousinOnceRemovedOf	inverse_girlFirstCousinOnceRemovedOf
inverse_boyFirstCousinOnceRemovedOf	inverse_boyFirstCousinOnceRemovedOf
inverse_daughterOf	inverse_daughterOf
inverse_sonOf	inverse_sonOf
inverse_granddaughterOf	inverse_granddaughterOf
inverse_grandsonOf	inverse_grandsonOf
inverse_greatGranddaughterOf	inverse_greatGranddaughterOf
inverse_greatGrandsonOf	inverse_greatGrandsonOf
inverse_nieceOf	inverse_nieceOf
inverse_nephewOf	inverse_nephewOf
